




NO ./1.xpm

SO       ./2.xpm

WE ./1.xpm
EA          ./3.xpm

F 50,10,15
C 100,90,200
        111111111111111111111111 
        1000000000000000E0000001
        100000000000000000000001
        1000000000000000000000001
111111111011000001110000000000001
100000000000000001110000000000001
111111111111111111111111111111111