NO ./1.xpm
SO ./2.xpm
WE ./1.xpm
EA ./2.xpm

F 50,10,15
C 100,90,200

        1111111111111111111111111
        1000000000110000000000001
        10110000010000000W0000001
        1001000000000000000000001
111111111011000001110000000000001
100000000011000001110111111111111
11110111111111011100000010001
11110111111111001101010010001
11000000110101011100000010001
10000000000000001100000010001
10000000000000001101010010111
1100000111010101111101111000111
11110111 1110101 101111010001
11111111 1111111 111111111111