




NO ./1.xpm

SO       ./2.xpm

WE ./1.xpm
EA          ./3.xpm

F 50,10,15
C 100,90,200
        111111111111111111111111 
        1000000000000000E001 
        1011111111111111111111111 
        101
        10111111111111 1111111111
        100000000100001010000001
        1001000000000000000000001
111111111011000001110000000000001
100000000011000001110111111111111
111111111111111111111111111111111
