




NO ./imgs/north.xpm




SO       ./imgs/south.xpm

WE ./imgs/west.xpm
EA          ./imgs/east.xpm

F 50,10,15
C 100,90,200
        111111111111111111111111 
        10000000000000000001 
        1011111111111111111111111 
        101
        1011111111111111111111111
        100000000100000000000001
        100100000000000W00100001
111111111011000001110000000000001
100000000011000001110111111111111
111111111111111111111111111111111
